{
	"map" : [
		[0,0,0,0,0,0,0,0,0,0,0,0,0,0,0,0,0,0,0,0,0,0,0,0,0,0,0,0,0,0,0,0,0,0,0,0,0,0,0,0],
		[0,0,3,3,3,0,0,0,0,0,0,0,0,0,0,0,0,0,0,0,0,0,0,0,0,1,1,1,1,3,3,3,3,3,3,0,0,0,0,0],
		[0,3,3,3,3,3,3,0,0,0,0,0,0,0,1,1,4,0,0,0,0,0,0,1,1,1,1,1,1,1,3,3,3,3,3,3,0,0,0,0],
		[0,3,3,3,3,3,1,1,1,1,0,0,0,1,1,4,1,4,0,0,0,0,1,1,1,2,2,2,2,2,2,2,2,3,3,3,0,0,0,0],
		[0,0,0,3,3,1,1,1,1,1,1,0,1,1,1,1,4,4,0,0,0,0,1,1,1,2,6,6,6,6,6,6,2,1,3,3,3,0,0,0],
		[0,0,0,0,3,1,1,1,2,2,2,2,2,2,6,2,2,0,0,0,0,1,1,1,1,2,6,6,6,6,6,6,2,1,1,1,3,0,0,0],
		[0,0,3,3,3,1,1,1,7,6,6,2,6,6,6,6,2,0,0,0,0,1,1,1,1,2,6,6,6,6,6,6,2,1,1,1,3,3,0,0],
		[0,0,3,1,1,1,1,1,2,6,6,6,6,6,6,6,7,0,0,0,0,1,1,1,1,2,2,2,2,2,2,6,2,2,2,1,1,3,0,0],
		[0,0,0,1,1,1,1,1,2,2,2,2,6,6,6,6,2,0,0,0,1,1,1,1,1,2,6,6,6,6,6,6,6,6,2,1,1,1,0,0],
		[0,0,0,0,1,1,1,1,1,1,1,2,6,2,7,2,2,0,0,1,1,1,1,1,1,2,6,6,2,6,6,6,6,6,2,1,1,1,0,0],
		[0,0,0,0,1,1,1,1,1,1,1,1,1,1,1,4,4,0,1,1,1,1,1,1,1,2,6,6,2,6,6,6,6,6,2,1,1,0,0,0],
		[0,0,0,0,0,0,1,1,1,1,1,1,1,4,1,0,0,0,1,1,1,1,1,1,1,2,6,6,2,6,6,6,6,6,2,1,0,0,0,0],
		[0,0,0,0,0,0,1,1,1,1,1,1,4,1,0,0,1,1,1,1,1,1,1,1,1,2,6,6,2,6,6,6,6,6,2,1,0,0,0,0],
		[0,0,0,0,0,0,0,0,1,8,1,1,1,0,0,1,1,1,1,1,1,1,1,1,1,2,2,6,2,2,2,2,2,2,2,0,0,0,0,0],
		[0,0,0,0,0,0,0,0,0,0,5,0,0,0,1,1,1,1,1,1,1,1,1,1,1,1,1,1,1,1,1,1,1,1,1,0,0,0,0,0],
		[0,0,0,0,0,0,0,0,0,0,5,0,0,0,0,1,1,1,1,1,1,1,1,1,1,1,1,1,1,1,1,1,1,1,1,1,0,0,0,0],
		[0,0,0,0,0,0,0,0,1,1,1,1,1,0,0,0,1,1,1,1,1,1,1,1,1,1,1,1,1,1,1,1,1,1,1,1,1,0,0,0],
		[0,0,0,0,0,0,0,1,1,1,1,1,1,1,0,0,0,0,1,1,1,1,1,1,1,1,1,1,1,1,1,1,1,1,1,1,1,0,0,0],
		[0,0,0,0,0,0,0,1,1,1,1,1,1,1,1,0,0,0,0,0,0,1,1,1,1,1,1,1,1,4,1,4,1,1,1,1,1,0,0,0],
		[0,0,0,0,0,0,0,0,1,1,1,1,1,1,1,0,0,0,0,0,0,0,1,1,1,1,1,1,4,1,4,1,1,1,1,1,0,0,0,0],
		[0,0,0,1,1,1,1,0,1,1,1,1,1,1,1,0,0,0,0,0,0,0,1,1,1,1,1,1,1,4,4,1,1,1,1,1,0,0,0,0],
		[0,0,0,0,1,1,1,0,0,1,1,1,1,1,1,1,1,1,1,0,0,0,0,0,1,1,1,4,1,4,1,1,1,1,1,1,1,0,0,0],
		[0,0,0,1,1,1,1,1,0,1,1,1,1,1,1,1,4,1,4,1,1,1,1,0,0,1,4,1,4,1,4,1,1,1,1,1,1,1,0,0],
		[0,0,1,1,1,1,1,1,0,1,1,1,1,1,1,1,1,4,1,4,1,1,1,1,0,1,1,1,1,4,1,1,1,1,1,1,1,1,0,0],
		[0,0,1,1,1,1,1,1,1,1,1,1,1,1,1,1,1,1,4,4,1,4,1,0,0,1,1,1,1,1,1,1,1,1,1,1,1,0,0,0],
		[0,0,1,1,1,1,1,1,1,1,1,1,1,1,1,1,1,1,1,1,4,1,1,0,0,0,1,1,1,1,1,1,1,1,1,1,0,0,0,0],
		[0,0,0,1,1,1,1,1,1,1,1,1,1,1,1,1,1,1,1,1,1,1,0,0,0,0,1,1,1,1,1,1,1,1,1,1,0,0,0,0],
		[0,0,0,1,1,1,1,1,1,1,1,1,1,1,1,1,1,1,1,1,1,0,0,0,0,0,0,1,1,1,1,1,1,1,1,1,0,0,0,0],
		[0,0,0,0,1,1,1,1,1,1,1,1,1,1,1,1,1,1,1,1,1,0,0,0,0,0,0,1,1,1,1,1,1,1,1,1,1,1,0,0],
		[0,0,0,0,1,1,1,4,1,1,1,1,1,1,1,1,1,1,1,1,1,1,0,0,0,0,1,1,1,1,1,1,1,1,1,1,1,3,0,0],
		[0,0,0,0,1,4,1,4,1,1,1,1,1,1,1,1,1,1,1,1,1,1,1,0,0,0,1,1,1,1,1,1,1,1,1,1,1,3,0,0],
		[0,0,0,3,1,1,4,1,1,1,1,1,1,1,1,1,1,1,1,1,1,1,1,0,0,1,1,1,1,1,1,1,1,1,1,1,3,3,0,0],
		[0,0,0,3,1,1,1,1,1,1,1,1,1,1,1,1,1,1,1,1,1,1,1,1,1,1,1,1,1,1,1,1,1,1,1,1,3,0,0,0],
		[0,0,3,3,3,1,1,1,1,1,1,1,1,1,1,1,1,1,1,1,1,1,1,1,1,1,1,1,1,1,1,1,1,1,3,3,3,0,0,0],
		[0,0,3,3,3,3,1,1,1,1,1,1,1,1,1,1,1,1,1,1,1,1,1,1,1,1,1,1,1,1,1,1,1,3,3,3,3,0,0,0],
		[0,0,0,3,3,3,3,3,3,1,1,1,1,1,1,1,1,1,1,1,1,1,1,1,1,1,1,1,1,1,1,1,3,3,3,3,0,0,0,0],
		[0,0,0,3,3,3,3,3,3,3,3,1,1,1,1,1,1,1,1,1,1,1,1,1,1,1,1,3,3,3,3,3,3,3,3,3,0,0,0,0],
		[0,0,0,0,3,3,3,3,3,3,3,3,0,0,1,1,1,1,1,1,1,1,1,1,1,3,3,3,3,3,3,3,3,3,3,3,0,0,0,0],
		[0,0,0,0,0,0,3,3,3,0,0,0,0,0,0,0,1,1,1,1,1,1,0,0,0,0,0,0,0,0,0,0,0,0,0,0,0,0,0,0],
		[0,0,0,0,0,0,0,0,0,0,0,0,0,0,0,0,0,0,0,0,0,0,0,0,0,0,0,0,0,0,0,0,0,0,0,0,0,0,0,0]
	],
	"width" : 41,
	"height" : 41,
	"player_x" : 2,
	"player_y" : 2,
	"interactions" : {
		"signpost" : {
			"13,9" : "Bridge to the plains"
		}
	}
}